Abang: Bang
Aku:  Aing Ak Eug Gue
Anjing: Ajg Anjim Anjeng
Ayo: Kuy Yuks Gas Skuy Yuk Yok
Bagaimana: Gmn 
Bagi: Bgi
Bagus: Bgs Sugab
Bajingan: Bjgn
Balikpapan: Bpn
Bandung: Bdg
Banget: Bgt Banged 
Banyak Pikiran: Galau
Bapak: Bpk Bokap Babe Abah Papa
Baru: Bru
Bawa Perasaan: Baper
Bayar Ditempat: COD
Begini: Bgni Gni 
Begitu: Bgtu
Belum: Blm Belom Blum
Berapa: Brp Brokap Beraps
Bergegas: Gercep GPL ASAP 
Berlebihan: Lebay Alay
Besar: Bsr Bsar
Besok: Bsk
Bisa: Bs Sabi 
Budak Cinta: Bucin
Bukan: Bkn
Butuh: Bth Btuh 
Cantik: Cntk
Capek: Cape Cpek Cpk
Cepat Sembuh: GWS
Cina: Cokin
Cuma: Cmn Cma
Curahan Hati: Curhat
Dari: Dr Dri
Datang: Dtg
Dekat: Dkt 
Dengan: Dg dgn
Dia: Doi Doski
Dimana: Dmn 
Disini: Dsni
Dulu: Dl Dlu
Enak: Enk Kane 
Enggak: Egk gag engk
Gembira: Cihuy Cihui Yuhu
Gitu: Gtu
Habis: Hbs Bais
Hancur: Caur
Ibu: Bu Emak Mama Mami Nyokap 
Ikut: Ikt
Ingin: Pgn
Ini: Ni
Iya: Y
Jadi: Jd Jdi
Jakarta: Jkt
Jangan: Jgn
Jawab: Jwb Jwab
Jelas: Jls
Juragan: Agan Gan
Kakak: Mas Ka Kak
Kalau: Kalo Klw Klo
Kamu: Km Kmu
Kayak: Kyk Ky Kek
Kecil: Kcl Kcil
Kenapa: Knp 
Keras: Kerad 
Keren: Sekut GG Goks
Kesal: Kzl Ksl
Ketahuan: Tercyduk
Kita: Kt
Lagi: Lg Lgi
Luar Biasa: Yahud
Malam: Mlm
Malang: Mlg
Malas: Mls
Masuk: Msk
Mati: Mokat Modar
Mau: BM Maw Mw 
Memang: Mmg Emg Emang
Menang: Mng
Menghubungi: Hub Hbungi
Mereka: Mrk
Misal: Msl
Mobil: Mbl Mbil
Motor: Mtr
Nanti: Nnti Nti
Nomor: Nmr No
Orang: Org
Padang: Pdg
Palembang: Plm
Pecah: Hacep
Penasaran: Kepo
Penis: Kontol Kntl
Pentas Seni: Pensi
Pepet Terus: PETRUS
Pesan Pribadi: DM
Polisi: Plokis Isilop
Pria: Cowo Cwo
Pujaan Hati: Gebetan 
Pulang: Plg
Purwokerto: Pwt
Sahabat: Sohib 
Sampai: Smp
Saya: Sy Ayas
Sayang: Syg Say Bebeb Ay
Sebentar: Bentar Bntr
Sekarang: Skrg
Semangat: Smngt Smgt
Semarang: Smrng
Semoga: Smg
Sendiri: Sendokir
Sepatu: Sepokat Patu 
Silahkan: Takis Sikat Ambil
Sini: Sni Sokin
Sudah: Sdh Udh 
Surabaya: Sby
Susah: Ssh
Tangan: Tgn
Tanggal: Tgl
Tapi: Tp Tpi
Teman: Tmn Tman
Terima kasih: Trims Thx Ty Makasi Mksh Trimaksh
Terserah: Trsrh Serah
Terus: Trs Trus
Tidak Berguna: Unfaedah
Tidak Jelas: Gaje Gjls Gajetot
Tidak Melakukan Apa-Apa: Gabut
Tidak Tahu: Gtw Gataw 
Tidak: Kadit Tdk Tida
Untuk: Utk Tuk
Waktu: Wkt
Wanita: Cewe Cwe
Yang: Yg 
Yogyakarta: Yk
